NO ./textures/wood.xpm
SO ./textures/brick.xpm
WE ./textures/magma.xpm
EA ./textures/water.xpm

C 100,66, 77
F 20,0,21

1111111111111111111111111
1001000000110000000000001
1010000121110000000000001
1001000S00210000000000001
10000000001100000111011111111111111
11111110101100000111000000000000001
11110111111111011100000010001111111
11110111111111011101010010001
11000000110101011100000010001
10000000000000001100000010001
10000000000000001101010010001
110000011101010111110111100011
11110111111010110111101000111
111111111111111111111111111
