NO ./textures/magma.xpm
SO ./textures/wood.xpm
WE ./textures/magma.xpm
EA ./textures/wood.xpm

F 100,66, 77
C 20,0,21

1111111111111111111111111
1001000000110000000000001
1012000121110000000000001
1001000S00020000000000001
10000000001100000111011111111111111
11111112101100000111000000000000001
11110111111111011100000010001111111
11110111111111011101010010001
11000000110101011100000010001
10000000000000001100000010001
10000000000000001101010010001
110000011101010111110111100011
11110111111010110111101000111
111111111111111111111111111
