NO ./textures/wood.xpm
SO ./textures/brick.xpm
WE ./textures/magma.xpm
EA ./textures/water.xpm

C 
F 20,0,21

1111111111111111111111111
1001000000110000000000001
1010000121110000000000001
1001000S00200000000000001
10000000001100000111011111111111111
11111110101100000111000000000000001
11110111111111011100000010001111111
11110111111111011101010010001
11000000110101011100000010001
10000000000000001100000010001
10000000000000001101010010001
100000011101010111110111100011
10110111111010110111101000111
101111111111111111111111111
101111111111111111111111111
101111111111111111111111111
101111111111111111111111111
101111111111111111111111111
101111111111111111111111111
101111111111111111111111111
101111111111111111111111111
101111111111111111111111111
111111111111111111111111111
