NO ./path_to_the_north_texture
SO ./path_to_the_south_texture
WE ./path_to_the_west_texture
EA ./path_to_the_east_texture

F 220,100,0
C 153, 0,204

1111111111111111111111111
1000000000110000000000000
1011000001110000000000001
1001000000000000000000001
100000000011000001110111111111111
111111111011000001110000000000000
111101111111110111000000100011111
11110111111111011101010010001
11000000110101011100000010001
100000000000S0001100000010001
10000000000000001101010010001
1100000111010101111101111000111
11110111 110101101 1101000111
11111111 111111111111111111
