NO ./path_to_the_north_texture
SO ./path_to_the_south_texture
WE ./path_to_the_west_texture
EA ./path_to_the_east_texture

F 220,100,66
C 153,0,21


1111111111111111111111111
1000000000110000000000001
1011000001110000000000001
1001000N00000000000000001
10000000001100000111011111111111111
11111111101100000111000000000000001
11110111111111011100000010001111111
11110111111111011101010010001
11000000110101011100000010001
10000000000000001100000010001
10000000000000001101010010001
110000011101010111110111100011
11110111111010110111101000111
111111111111111111111111111
